................................XX.X...........................
...............................XXX.X......X.X..................
..............................X....X.X....X....................
...............................XX......X.X...X.................
................................X...X..X..XX...................
...................................X.XX...X....................
..................................X.X................XX........
..................................X.X................XX........
...............................................................
...............................................................
...............................................................
...............................................................
...............................................................
...............................................................
.............................................................XX
....................................................XX.......XX
.......................................X.........X.XXXX........
..................................X...XXXXX.....XX.X...XX......
.................................X.X.......XX....X..XX.XX......
.................................X.......X.XX.....XXXXXX.......
..................................X........XX......X...........
...................................X...XXXX....................
........................................XXX....................
........................X.X.........XX.........................
........................X.X.X......X.X.........................
.......................X..XX.X....XX...........................
........................XX...X.X.XX.X..........................
........................XX...XX.XXXXX..........................
............................X.XX...XX..........................
...........................X.X.................................
..XX.X.........................................................
.XXX.X......X.X................................................
X....X.X....X..................................................
.XX......X.X...X...............................................
..X...X..X..XX...........X.....................................
.....X.XX...X...........XXX....................................
....X.X.................X..X...................................
....X.X................X....X..................................
........................X......................................
...............................................................
........................X..X...................................
.........................X.X...................................
...............................................................
.....................X.........................................
....................XXX........................................
...................XX.XX.......................................
.........X........XX.X.....X...................................
....X...XXXXX....XX......XX....................................
...X.X.......XX..XX.......XX...................................
...X.......X.XX................................................
....X........XX................................................
.....X...XXXX..................................................
..........XXX..................................................
...............................................................
...............................................................
...............................................................
...........XX..................................................
...........XX..................................................
